NO assets/north.xpm
SO assets/south.xpm
WE assets/west.xpm
EA assets/east.xpm

F 43,24,12
C 0,191,255

1111111111111111111111111
10S0110000100000000000001
1000110 00000000111111001
1000110000001100 10000001
1000000000100000000001001
1111111111111111111111111
